WWWWWWWWWWWWWWWWWWWWWWWWWWWWWW
WMMMMMMMMMMMMMMMMMMMMMMMMMMMFW
WMMFFFFFFFFFFFFFFFFFFFFFFFFFW
WMMFFFFFPPPPPPPPPPPPPPPPFFFFW
WMMFFFFFPPPPCCPPPPPPPPPPFFFFW
WMMFFFFFPPPPPPPPPPPPPPPPFFFFW
WMMFFFFFPPPPPPPPPPPPPPPPFFFFW
WMMMMFFFPPPPPPPPPPPPPPPPFFFFW
WMMMMFFFPPPPCCPPPPPPPPPPFFFFW
WMMMMFFFPPPPPPPPPPPPPPPPFFFFW
WMMMMFFFPPPPPPPPPPPPPPPPFFFFW
WMMMMFFFPPPPPPPPPPPPPPPPFFFFW
WMMMMFFFPPPPCCPPPPPPPPPPFFFFW
WMMMMFFFPPPPPPPPPPPPPPPPFFFFW
WMMMMFFFPPPPPPPPPPPPPPPPFFFFW
WMMMMFFFPPPPPPPPPPPPPPPPFFFFW
WMMMMFFFPPPPPPPPPPPPPPPPFFFFW
WMMMMFFFPPPPPPPPPPPPPPPPFFFFW
WMMMMFFFPPPPPPPPPPPPPPPPFFFFW
WWWWWWWWWWWWWWWWWWWWWWWWWWWWWW
